WWWWEWWWW
      W W
W WWW W W
W W      
W WWWW WW
W  W    W
WWWW WWWW
W       W
WWWWXWWWW